2 2 2 2 2 2 2 2 2 2 2 2 2 2 2 2 2 2 2 2 2 2 2 2 2 2 2 2 2 2
2 2 0 0 0 0 0 0 0 0 0 0 0 0 2 2 0 0 0 0 0 0 0 0 0 0 0 0 2 2
2 2 0 2 2 2 2 0 2 2 2 2 2 0 2 2 0 2 2 2 2 2 0 2 2 2 2 0 2 2
2 2 0 2 2 2 2 0 2 2 2 2 2 0 2 2 0 2 2 2 2 2 0 2 2 2 2 0 2 2
2 2 0 2 2 2 2 0 2 2 2 2 2 0 2 2 0 2 2 2 2 2 0 2 2 2 2 0 2 2
2 2 0 0 0 0 0 0 0 0 0 0 0 0 0 0 0 0 0 0 0 0 0 0 0 0 0 0 2 2
2 2 0 2 2 2 2 0 2 2 0 2 2 2 2 2 2 2 2 0 2 2 0 2 2 2 2 0 2 2
2 2 0 2 2 2 2 0 2 2 0 2 2 2 2 2 2 2 2 0 2 2 0 2 2 2 2 0 2 2
2 2 0 0 0 0 0 0 2 2 0 0 0 0 2 2 0 0 0 0 2 2 0 0 0 0 0 0 2 2
2 2 2 2 2 2 2 0 2 2 2 2 2 3 2 2 3 2 2 2 2 2 0 2 2 2 2 2 2 2
2 2 2 2 2 2 2 0 2 2 2 2 2 3 2 2 3 2 2 2 2 2 0 2 2 2 2 2 2 2
2 2 2 2 2 2 2 0 2 2 5 3 3 3 4 3 3 3 3 1 2 2 0 2 2 2 2 2 2 2
2 2 2 2 2 2 2 0 2 2 2 2 2 2 2 2 2 2 2 2 2 2 0 2 2 2 2 2 2 2
2 2 2 2 2 2 2 0 2 2 3 2 2 2 2 2 2 2 2 3 2 2 0 2 2 2 2 2 2 2
2 2 3 3 3 3 5 0 3 3 3 2 2 2 2 2 2 2 2 3 3 3 0 5 3 3 3 3 2 2
2 2 2 2 2 2 2 0 2 2 3 2 2 2 2 2 2 2 2 3 2 2 0 2 2 2 2 2 2 2
2 2 2 2 2 2 2 0 2 2 3 2 2 2 2 2 2 2 2 3 2 2 0 2 2 2 2 2 2 2
2 2 2 2 2 2 2 0 2 2 3 3 3 1 5 5 1 3 3 3 2 2 0 2 2 2 2 2 2 2
2 2 2 2 2 2 2 0 2 2 3 2 2 2 2 2 2 2 2 3 2 2 0 2 2 2 2 2 2 2
2 2 2 2 2 2 2 0 2 2 5 2 2 2 2 2 2 2 2 5 2 2 0 2 2 2 2 2 2 2
2 2 0 0 0 0 0 0 0 0 0 0 0 0 2 2 0 0 0 0 0 0 0 0 0 0 0 0 2 2
2 2 0 2 2 2 2 0 2 2 2 2 2 0 2 2 0 2 2 2 2 2 0 2 2 2 2 0 2 2
2 2 0 2 2 2 2 0 2 2 2 2 2 0 2 2 0 2 2 2 2 2 0 2 2 2 2 0 2 2
2 2 0 0 0 2 2 0 0 0 0 0 0 0 5 5 0 0 0 0 0 0 0 2 2 0 0 0 2 2
2 2 2 2 0 2 2 0 2 2 0 2 2 2 2 2 2 2 2 0 2 2 0 2 2 0 2 2 2 2
2 2 2 2 0 2 2 0 2 2 0 2 2 2 2 2 2 2 2 0 2 2 0 2 2 0 2 2 2 2
2 2 0 0 0 0 0 0 2 2 0 0 0 0 2 2 0 0 0 0 2 2 0 0 0 0 0 0 2 2
2 2 0 2 2 2 2 2 2 2 2 2 2 0 2 2 0 2 2 2 2 2 2 2 2 2 2 0 2 2
2 2 0 0 0 0 0 0 0 0 0 0 0 0 0 0 0 0 0 0 0 0 0 0 0 0 0 0 2 2
2 2 2 2 2 2 2 2 2 2 2 2 2 2 2 2 2 2 2 2 2 2 2 2 2 2 2 2 2 2